00000000000000000000
00000000111000000000
00001111100000000000
00001000000000000000
21111111110001111100
01000000011111000000
01111000001000000000
00000001111111111000
00000000000000001110
00000111111111111000
00111100000000001111
00000111100000000000
00000000111111000000
00000000000001111000
00000000000000010000
00000000000000011100
31111110000001110000
00001000111111000000
00001111100000000000
00000001110000000000