21100000000000000000
00111111111100000000
00100010000111111100
01100010000000000100
01000011110001111100
01000000001111000000
01100000001000000000
00100000001111111000
00000000000000001110
00000111111111111000
00111100000000000000
00001111100000000000
00000001111111000000
00011111000111111000
00010000000000110000
00010000000000011100
00011111100001110000
00000111110000000000
00001100011111011110
00000001110001110013