00000000020000000000
00111111111100000000
00100010000111100000
01100010000000000100
01000011110001111100
01000000000111000000
01100000000000000000
00100000000001111000
00111110000000001110
00000111111110000000
00111100000000000000
00001111100000000000
00000001111111000000
00011111000001111000
00010000000000110000
00010000000000011100
00011111100001110000
00000111110000000000
00000000011111011113
00000111110001110000