00000000000000000000
00111100000000000000
00000111111110000000
00000100000011110000
00000100000000000000
00000111110000000000
00000000011111110000
00001111110000011110
21111000000000000000
00001110000000000000
00000010000000000000
00000011110000000000
00000000011111111000
00000000010000000000
00000000010000000000
00000111111110000000
00000100000011110000
01111111000000010000
00000000000000010000
00000000031111110000